XXXXXXXXXXXXXXXXXXXXXXXXXXXXXXXXXXXXXXXXXXXXXXXXXXXXXXXXXXXXXXXXXXXXXXXXXXXXXXXXXXXXXXXXXXXXXXXXXXXXX
X           X           X         X             X   X       X         X       X           X   X     X
XXXXXXXXX X XXX XXX XXX X X XXXXXXX XXX XXXXXXX X X XXX XXX X XXXXX XXX X XXX X XXXXXXX X X XXX X XXX
X         X   X   X X   X X   X     X X   X   X   X X   X   X X   X     X X   X X     X X   X   X   X
X XXXXXXXXXXX XXXXX XXX XXX X X XXXXX XXX X XXXXXXX X XXXXXXX X X XXXXXXX X XXX X XXXXX XXXXX XXXXX X
X X               X   X   X X     X     X X   X     X X     X   X X       X X   X     X       X X   X
X XXXXXXXXXXXXXXX XXX XXX XXXXXXX X XXXXX X X X XXXXX X XXX XXXXX X XXXXXXX X XXXXXXX XXXXX XXX X X X
X   X   X   X   X X   X X       X X X   X X X X   X   X X X   X   X X     X X X       X   X     X X X
X X X X X X X X X X XXX XXXXXXX X X X X X XXX XXX X X X X XXX X XXX X XXX XXX X XXX XXX X X XXXXX X X
X X   X   X   X X   X X       X X   X X   X   X   X X X X X   X X   X X   X   X X   X   X X X     X X
XXXXXXXXXXX XXX XXXXX X XXX XXX XXX X XXXXX XXX XXX X X X X XXX X X X X X X XXX XXXXX XXX XXX XXXXX X
X         X   X X   X     X   X X   X X     X   X   X X X X   X X X X X X X   X     X X       X   X X
X XXXXXXX XXXXX X X XXXXX XXX X X XXX X XXX X XXXXXXX X X XXX X X XXX X X XXX XXXXX X XXXXXXXXX XXX X
X     X X X   X X X     X X   X X X   X   X         X X X   X   X     X X   X X     X       X       X
X XXX X X X X X X XXXXX XXX X X X X X XXXXXXXXXXXXX X X X X XXXXXXXXXXX XXX X X XXX XXXXXXX XXXXX XXX
X   X X X   X X       X X   X X X X X X         X   X X X X X       X X   X X X X X X     X     X X X
XXX X X XXXXX XXXXXXXXX X XXX X XXX X X XXXXXXX X XXX X X X X X XXX X XXX X X X X X XXXXX XXXXX XXX X
X   X X     X     X   X X X   X X   X X     X   X   X X X X   X   X     X X X   X   X       X X   X X
X XXX X XXXXXXXXX X X X X XXX X X XXX XXXXX X XXXXX X X XXXXXXXXX X XXXXX XXXXXXX XXX XXXXX X XXX X X
X X   X     X     X X   X   X X X X X X X   X X   X X X           X X     X     X X   X   X   X X   X
X X XXX XXX X XXXXX XXXXXXX XXX X X X X X XXX XXX X X XXXXX XXXXXXX X XXX X X XXX XXX XXX XXX X XXXXX
X X   X   X X X     X     X X     X     X   X X   X X     X X     X X X   X X   X     X     X X     X
X XXX XXXXX X X X XXX XXX X X XXXXXXXXXXXXX X X X X X XXXXX X XXX XXX X XXX XXX XXXXXXX XXXXX X X XXX
X   X     X     X X   X X X   X         X   X X X X X   X   X   X X   X X   X     X   X X     X X   X
XXX XXXXX XXXXXXXXX XXX X X XXX XXXXXXX X XXX X XXX XXX X XXXXX X X XXXXX XXX XXX X X X X XXXXXXXXX X
X   X   X X       X X   X X X   X   X   X X   X         X X   X X   X       X X     X   X           X
XXXXX X X X XXXXX X X XXX XXX XXX X X X X X XXXXXXXXXXX X X X X X XXX XXXXXXX XXXXXXXXXXXXXXXXXXXXX X
X     X   X   X   X   X   X   X   X   X X X X   X   X   X X X   X X   X       X                 X   X
X XXXXXXXXXXX X XXXXX X XXX XXX XXXXXXXXX X X X X X XXXXX X XXXXXXX XXX XXXXXXX XXXXXXX XXXXXXXXX XXX
X             X       X       X           X   X   X       X           X               X             X
XXXXXXXXXXXXXXXXXXXXXXXXXXXXXXXXXXXXXXXXXXXXXXXXXXXXXXXXXXXXXXXXXXXXXXXXXXXXXXXXXXXXXXXXXXXXXXXXXXXXX
start 1, 1
end 29, 1